#####################################
#                                   #
#   S                            #E #
#                                   #
#####################################
